%%%%%%%%%%%%%%%%%%%%%%%%%%%%%%%%%%%%
%                                 P%
% %%%%%%%%%%%%%%%%%%% %%% %%%%%%%% %
% %%   %   %      %%% %%%   %% ... %
% %% % % % % %%%% %%%%%%%%% %% %%%%%
% %% % % % % %    %%     %% %% ... %
% %% % % % % % %%%%  %%%    %%%%%% %
% %  % % %    %   %% %%%%%%%%  ... %
% %% % % %%%%%%%% %%        %% %%%%%
% %% %G   %%      %%%%%%%%% %% ... %
%    %%%%%% %%%%%%%      %% %%%%%% %
%%%%%%      %    G  %%%% %% %  ... %
%      %%%%%% %%%%% %    %% %% %%%%%
% %%%%%%      %       %%%%% %%     %
%        %%%%%% %%%%%%%%%%% %%  %% %
%%%%%%%%%%                  %%%%%% %
%.         %%%%%%%%%%%%%%%% ...... %
%%%%%%%%%%%%%%%%%%%%%%%%%%%%%%%%%%%%