%%%%%%%%%%%%%%%%%%%%%%%%%%%%%%%%%%%%%%
%P                                   %
% %%    %   %  % % %%% % %%%     % % %
%       %%  %  %      % %%% % % % % %%
% %      %    %   %  %%     %  .  % %%
%   %     %  %   %  %  %   .%G%  %% %%
%  %  %%     %%  %% %%  %  % %    %% %
% %%  %%% %%             .  %   %%%  %
%  %       %    % %    %    %% %     %
%    %%      %% %   %   % % % %% %% %%
% % %%  % % %%%%%% % %%  %% %  %     %
% % %   %    %   % G    %  %%  %  % %%
%   %         %    %%%%  %%  %% %   %%
% .    %% %   %  %%%%   %%% %    %%  %
%                     %   %%%% %  % %%
%    .  %  %   %%%    % %%       %%% %
%   %     %  %%% %% %     %   %   %%%%
%%%%%%%%%%%%%%%%%%%%%%%%%%%%%%%%%%%%%%
