%%%%%%%%%%%%%%
%.       . % %
%          % %
%.         %G%
%          % %
%.         % %
%          % %
%.         % %
%     P    %G%
%.         % %
%          % %
%          % %
%          % %
%%%%%%%%%%%%%%
