%%%%%%%%%%%%%%%%%%%%%%
%.%%        % %     .%
%    %%%%%% % %%%%%% %
%% %%%     P  %      %
%    % %%%%%% %% %%%%%
% %%%% %         %   %
%        %%% %%%   % %
%% %%%%%%%    %%%%%% %
%.         %%       .%
%%%%%%%%%%%%%%%%%%%%%%
