%%%%%%%%%%%%%%%%%%%%%%%%%%%%
% .          %%          . %
% %%%% %%%%% %% %%%%% %%%% %
% %%%% %%%%% %% %%%%% %%%% %
% %%%% %%%%% %% %%%%% %%%% %
%                          %
% %%%% %% %%%%%%%% %% %%%% %
% %%%% %% %%%%%%%% %% %%%% %
% .    %%    %%    %%    . %
%%%%%% %%%%% %% %%%%% %%%%%%
%%%%%% %%%%% %% %%%%% %%%%%%
%%%%%% %   G     G  % %%%%%%
%%%%%% % %%%%  %%%% % %%%%%%
%        %        %        %
%%%%%% % %%%%%%%%%% % %%%%%%
%%%%%% %            % %%%%%%
%%%%%% % %%%%%%%%%% % %%%%%%
%            %%            %
% %%%% %%%%% %% %%%%% %%%% %
% %%%% %%%%% %% %%%%% %%%% %
%   %%                %%   %
%%% %% %% %%%%%%%% %% %% %%%
% .    %%    %%    %%   .  %
% %%%%%%%%%% %% %%%%%%%%%% %
%             P            %
%%%%%%%%%%%%%%%%%%%%%%%%%%%%
