%%%%%%%%%%%%%%%%%%%%
%    %..G.....%....%
%.%%.%.%%..%%.%.%%.%
%.%.....%..%..o..%.%
%.%.%%.%%..%%.%%.%.%
%...o......G%.%.o..%
%.%....%%%%%%.%..%.%
%.%..o.%....%.%..%.%
%.%....%.%%%%.%..%.%
%.%....o......%..%.%
%.%%.%.%%%%%%.%.%%.%
%....%...P....%....%
%%%%%%%%%%%%%%%%%%%%
