%%%%%%%%%%%%%%%%%%%%
% .   %  .    %  . %
% %%   %%  %% % %% %
% %  .           % %
% % %% %%  %% %% % %
%          G% %  . %
% %    %%%%%% %  % %
% %    %    % %  % %
% %    % %%%% %  % %
% %   .       %  % %
% %% % %%%%%% % %% %
%.   %   P G  %   .%
%%%%%%%%%%%%%%%%%%%%
