%%%%%%%%%%%%%%%%%%%%%%%%%%%%%%%%%%%%%%
%                                   P%
% %%%%%%%%%%%%%%%%%%% %%% .%%%%%%%%  %
% %%   %   %      %%% %%%    %%GG    %
% %% % % % % %%%% %%%%%%%%%  %%  %%%%%
% %% % % % % % .  %%GG       %%      %
% %% % % % % % %%%%%  %%%    %%%%%%  %
% %% % % %   %    %%  %%%%%%%%%      % 
% %% % % %%%%%%%% %%  .      %%  %%%%%
% %% %   %%       %%%%%%%%%  %%      %
%    %%% %% %%%%%%%      %%  %%%%%%  %
%%%%%%      %       %    %%  %%      %
%      %%%%%% %%   %%    %%  %%  %%%%%
% %%%%%%      %       %%%%%  %%      %
%          %%%%       %%%%%  %%%%%%  %
%%%%%%%%   %                 %%%%%%  %
%.         %%%%%%%%%%%%%%%%          %
%%%%%%%%%%%%%%%%%%%%%%%%%%%%%%%%%%%%%%