%%%%%%%%%%%%%%%%%%%%%%%%%%%%%%%%%%%%%%
%                                   P%
% %%%%%%%%%%%%%%%%%%% %%% .%%%%%%%%  %
% %%   %   %      %%% %%%    %%GG    %
% %% % % % % %%%% %%%%%%%%%  %%  %%%%%
% %% % % % % % .  %%         %%      %
% %% % % % % % %%%%%  %%%    %%%%%%  %
% %% % % %   %    %%  %%%%%%%%%      % 
% %% % % %%%%%%%% %%  .      %%  %%%%%
% %% %   %%       %%%%%%%%%  %%      %
%    %%% %% %%%%%%%      %%  %%%%%%  %
%%%%%%      %       %    %%  %%      %
%   G  %%%%%% %%   %%    %%  %%  %%%%%
% %%%%%%      %       %%%%%  %%      %
%          %%%%    G  %%%%%  %%%%%%  %
%%%%%%%%   %                 %%%%%%  %
%.         %%%%%%%%%%%%%%%%          %
%%%%%%%%%%%%%%%%%%%%%%%%%%%%%%%%%%%%%%