%%%%%%%%%%%%%%%%%%%%
%        .....     %
% % %%%%%%%%%%%% % %
%                  %
%%%%%%%% % %%%%%%%P%
%%%%%%%%           %
%%%%%%%%%%%%%%%%%%%%
