%%%%%%%%%
% .     %
%. .    %
% .     %
%. .    %
%       %
%  .    %
%       %
%P .    %
%%%%%%%%%
